#############
#           #
# P  B   X  #
#           #
#############