 #########      
 # P # X #      
 # B #   #      
 ## ### ########
  # # #        #
  # # #  ####  #
### # ####  # ##
#   ######### # 
#             # 
############  # 
           #### 