#####          #####
# X #          #   #
#   ############ B #
#                P #
#   ############ B #
# X #          #   #
#####          #####