        ###         
        #X#         
        #M# #####   
   ###### ###   #   
   #          B #   
#### #### ##### ####
#XM  B   P   #   MX#
#### #       #  ####
   # ##########B#   
   #            #   
   ##############   