############   
#       P  ####
#    B  B  MXX#
#          ####
############   